"a" = (/turf/Ground/Dirt,/area)
"b" = (/turf/Ground/Sand,/area)

(1,1,1) = {"
aaaaaabbbb
aaaaabbbbb
aaaababbbb
aabbbbbbbb
aabbbbbbbb
bababbbbbb
bbbbbbbbbb
bbbbbbbbbb
bbabbbbbbb
bbbbbbbbbb
"}
